#########
#  O    #
#  X    #
#  P    #
#       #
#     ###