### #####
#  P    #
#  X    #
#  O    #
#########