#########
#  P  d #
#  X    #
#  O    #
#########