              ####   
         ######  #   
         #       #   
         #  #### ### 
 ###  ##### ###    # 
##P####       #    # 
#             #....##
#     #       #.....#
#     #  OX   #.....#
###   #       #.....#
  #   #       #.....#
  # ####### ###.....#
  #   #       #.....#
  ### #       #######
    # #         #    
    # #         #    
    # #       # #    
    # ######### #    
    #           #    
    #############    