##########
#  X O   #
#   P    #
#        #
##########